11111111111111111111
12000000000000000001
10101111011111110101
10100001011110000101
10111101000000110101
10111101101010111101
10000101101000000001
11110101101111101111                 
11110000000000001111                
11110111101111101111                
10000000101000000001                 
10111011101011101101               
10101011000011100001                
10101011010110111101               
10001000010000101101                 
10101110010101101101                
10100000100000000001               
10111110111101101101                 
10000000000000000001                 
11111111111111111111
